NO assets/north.xpm
SO assets/south.xpm
WE assets/west.xpm
EA assets/east.xpm

SK assets/Night_Sky.xpm
F assets/floor.xpm

END assets/final_door.xpm
G assets/gun.xpm
GS assets/gun_shut.xpm

Z0 assets/zombie0.xpm
Z1 assets/zombie1.xpm
Z2 assets/zombie2.xpm

D1 assets/doors/door_close.xpm
D2 assets/doors/door_opening1.xpm
D3 assets/doors/door_opening2.xpm
D4 assets/doors/door_opening3.xpm
D5 assets/doors/door_open.xpm

H1 assets/health/h100.xpm
H2 assets/health/h80.xpm
H3 assets/health/h60.xpm
H4 assets/health/h40.xpm
H5 assets/health/h20.xpm

A6 assets/ammo/am6.xpm
A5 assets/ammo/am5.xpm
A4 assets/ammo/am4.xpm
A3 assets/ammo/am3.xpm
A2 assets/ammo/am2.xpm
A1 assets/ammo/am1.xpm
A0 assets/ammo/am0.xpm

R1 assets/heart/he1.xpm
R2 assets/heart/he2.xpm
R3 assets/heart/he3.xpm
R4 assets/heart/he4.xpm
R5 assets/heart/he5.xpm
R6 assets/heart/he6.xpm
R7 assets/heart/he7.xpm
R8 assets/heart/he8.xpm
R9 assets/heart/he9.xpm
R10 assets/heart/he10.xpm
R11 assets/heart/he11.xpm
R12 assets/heart/he12.xpm

CA1 assets/c_ammo/c_ammo1.xpm
CA2 assets/c_ammo/c_ammo2.xpm
CA3 assets/c_ammo/c_ammo3.xpm
CA4 assets/c_ammo/c_ammo4.xpm
CA5 assets/c_ammo/c_ammo5.xpm
CA6 assets/c_ammo/c_ammo6.xpm
CA7 assets/c_ammo/c_ammo7.xpm
CA8 assets/c_ammo/c_ammo8.xpm
CA9 assets/c_ammo/c_ammo9.xpm
CA10 assets/c_ammo/c_ammo10.xpm
CA11 assets/c_ammo/c_ammo11.xpm
CA12 assets/c_ammo/c_ammo12.xpm

K1 assets/key/key1.xpm
K2 assets/key/key2.xpm
K3 assets/key/key3.xpm
K4 assets/key/key4.xpm
K5 assets/key/key5.xpm
K6 assets/key/key6.xpm
K7 assets/key/key7.xpm

11111111111111111111111111111111111111111111111111
10000000000000000001111111110000000000000000000001
10111111111111111001111111110111111111111111111001
10100000000000001000000000010100000000000000001001
10101111111110101111111011110101111111111110101001
10101000000010100000001000000101000000000100101001
10101011111110111110101111110101111110110111101001
10101010000000000010100000010101000010110000101001
10101010111111111010101111110101111010111110101001
10101010100000001010100000000100001010000010101001
10101010101111101010111111111110111011111010101001
10100000100000101010000000000000101000001010001001
10111111101110101010111111111110101111101010111001
10000000001000100010100000000000100000100010000001
11110111111011111010101111111111101110111111111001
10010100000010000010100000000000101010000000101001
10110101111011111010111110111110101010111110101001
10100001001000001010100010000000100010000010101001
10101111001111101010101110111111101110111010101001
10100000000000100010100000100000000000100000101001
10111110111110111010111110101111111110111110101001
10000010100000100010000010101000000010100000101001
10111010101110111110111110101110111010101111101001
10100010101000000000100000100010001010001000001001
10101111101111111111101111111110101110101111111001
10001000001000000000001000000010100010100000000001
10111011111011101110111011111010111010111110111001
10001010000010100010000010001000001000000010001001
10111010111110101010111110101111101111111010111001
10100010000010101010000000000000100000001010001001
10101110111010101010101111111110101111101010101001
10100000101000100010101000000000100000100010101001
10111111101110111010101110111111111010111010101001
10000000000000001010000010100000001010000010100001
10111011111011111010111110101110101011111110111111
1010001000101000101000100000101010001000000000000F
10101110101010101010101111101010111010111110111001
10000000100000100000100000000010000010000000000001
11111111111111111111111111111111111111111111111111

