NO assets/floor/surface_square_future.xpm
SO assets/floor/surface_square_future.xpm
WE assets/floor/surface_square_future.xpm
EA assets/floor/surface_square_future.xpm

SK assets/sky_ceiling/Night_Sky.xpm
F assets/floor/surface_square_future.xpm

END assets/final_door/final_door_future.xpm
G assets/gun/gun_future_new.xpm
GS assets/gun/future_blast.xpm

Z0 assets/zombies/robot_left.xpm
Z1 assets/zombies/robot_right.xpm
Z2 assets/zombies/robot_central.xpm

D1 assets/doors/door_future1.xpm
D2 assets/doors/door_future2.xpm
D3 assets/doors/door_future3.xpm
D4 assets/doors/door_future4.xpm
D5 assets/doors/door_future5.xpm
D6 assets/doors/door_future6.xpm

H1 assets/health/h100.xpm
H2 assets/health/h80.xpm
H3 assets/health/h60.xpm
H4 assets/health/h40.xpm
H5 assets/health/h20.xpm

A6 assets/ammo/am6.xpm
A5 assets/ammo/am5.xpm
A4 assets/ammo/am4.xpm
A3 assets/ammo/am3.xpm
A2 assets/ammo/am2.xpm
A1 assets/ammo/am1.xpm
A0 assets/ammo/am0.xpm

R1 assets/heart/he1.xpm
R2 assets/heart/he2.xpm
R3 assets/heart/he3.xpm
R4 assets/heart/he4.xpm
R5 assets/heart/he5.xpm
R6 assets/heart/he6.xpm
R7 assets/heart/he7.xpm
R8 assets/heart/he8.xpm
R9 assets/heart/he9.xpm
R10 assets/heart/he10.xpm
R11 assets/heart/he11.xpm
R12 assets/heart/he12.xpm

CA1 assets/c_ammo/c_ammo1.xpm
CA2 assets/c_ammo/c_ammo2.xpm
CA3 assets/c_ammo/c_ammo3.xpm
CA4 assets/c_ammo/c_ammo4.xpm
CA5 assets/c_ammo/c_ammo5.xpm
CA6 assets/c_ammo/c_ammo6.xpm
CA7 assets/c_ammo/c_ammo7.xpm
CA8 assets/c_ammo/c_ammo8.xpm
CA9 assets/c_ammo/c_ammo9.xpm
CA10 assets/c_ammo/c_ammo10.xpm
CA11 assets/c_ammo/c_ammo11.xpm
CA12 assets/c_ammo/c_ammo12.xpm

K1 assets/key/key1.xpm
K2 assets/key/key2.xpm
K3 assets/key/key3.xpm
K4 assets/key/key4.xpm
K5 assets/key/key5.xpm
K6 assets/key/key6.xpm
K7 assets/key/key7.xpm

11111111111111111111111111111111111111111111111111
10000001H0000110100000F0000000ZZZAAK00000D000000W1
1000Z00D00Z001101000001111111111D111111111111D1111
1A00000100000110100000D000000000000000000000000001
1111111111D1111010000011111111111111111111111D1111
10000000000000000000000000000000000000000100000001
10000000000000000000000000000000000000000100000001
111D111111D1111111D1111111111D1111111111D111111111
10000010000000100000000100000000000100000000000001
10000010000000100000000100000000000100000000000001
10000010000000100000000100000000000100000000000001
10000010000000100000000100000000000100000000000001
11111111111111111111111111111111111111111111111111
11111111111111111111111111111111111111111111111111
11111111111111111111111111111111111111111111111111
11111111111111111111111111111111111111111111111111

