
C 52, 174, 235

NO assets/north.xpm
SO assets/south.xpm


F 77, 209, 106

WE           assets/west.xpm
EA assets/east.xpm

        111 111111111111111111111
        1011100000110000000000001
        10110000011100000000000011
        1001000000000000000000001
111111111011000001110000000000001
110000000011000001110111111111111
111101111111111111000000100111
11110111111111   1010100100111
110000001101011111000100100001
100000000000000011000100100011
10000000000000001101000000011
11000001110101011111011110N0111
11110001 1110101 100011000001
11111111 1111111 111111111111
