

D assets/door.xpm
NO assets/north.xpm
SO assets/south.xpm
G assets/gun.xpm
GS assets/gun_shut.xpm
F assets/floor.xpm

WE           assets/west.xpm
EA assets/east.xpm
SK assets/Night_Sky.xpm

        111 111111111111111111111
        1011100000110000000000001
        1011000001110E000000000011
        1000000000000000000000001
111111111011000001110000000000001
110000000011000000000111111111111
111001111111111111000000100111
111001111111   111010100D00111
110000001111111111000D00D00001
100000000000000011000100100011
10000000000000001101000000011
1100000111010101111101111000111
11110001 1111101 100011000001
11111111 111 111 111111111111


