

NO assets/north.xpm
SO assets/south.xpm
WE assets/west.xpm
EA assets/east.xpm

SK assets/Night_Sky.xpm
F assets/floor.xpm

G assets/gun.xpm
GS assets/gun_shut.xpm

Z assets/zombie.xpm

D assets/door.xpm

H1 assets/health/h100.xpm
H2 assets/health/h80.xpm
H3 assets/health/h60.xpm
H4 assets/health/h40.xpm
H5 assets/health/h20.xpm

A6 assets/ammo/am6.xpm
A5 assets/ammo/am5.xpm
A4 assets/ammo/am4.xpm
A3 assets/ammo/am3.xpm
A2 assets/ammo/am2.xpm
A1 assets/ammo/am1.xpm
A0 assets/ammo/am0.xpm

R1 assets/heart/he1.xpm
R2 assets/heart/he2.xpm
R3 assets/heart/he3.xpm
R4 assets/heart/he4.xpm
R5 assets/heart/he5.xpm
R6 assets/heart/he6.xpm
R7 assets/heart/he7.xpm
R8 assets/heart/he8.xpm
R9 assets/heart/he9.xpm
R10 assets/heart/he10.xpm
R11 assets/heart/he11.xpm
R12 assets/heart/he12.xpm

CA1 assets/c_ammo/c_ammo1.xpm
CA2 assets/c_ammo/c_ammo2.xpm
CA3 assets/c_ammo/c_ammo3.xpm
CA4 assets/c_ammo/c_ammo4.xpm
CA5 assets/c_ammo/c_ammo5.xpm
CA6 assets/c_ammo/c_ammo6.xpm
CA7 assets/c_ammo/c_ammo7.xpm
CA8 assets/c_ammo/c_ammo8.xpm
CA9 assets/c_ammo/c_ammo9.xpm
CA10 assets/c_ammo/c_ammo10.xpm
CA11 assets/c_ammo/c_ammo11.xpm
CA12 assets/c_ammo/c_ammo12.xpm

K1 assets/key/key1.xpm
K2 assets/key/key2.xpm
K3 assets/key/key3.xpm
K4 assets/key/key4.xpm
K5 assets/key/key5.xpm
K6 assets/key/key6.xpm
K7 assets/key/key7.xpm

        111 1111111111111111111111
        101110000011000AA00000Z011
        1011000001110E0H000H0Z0011
        100000000000000K0D0Z000011
1111111110110000011100000000000011
1100000000110000000001111111111111
111001111111111111000000100111
111001111111   111010100D00111
110000001111111111000D00D00001
100000000000000011000100100011
100000000000000011010000000111
110000011101010111110111DDD111
11110001 1111101 1000110000011
11111111 111 111 1111111111111


