
C assets/ceiling.xpm

D assets/door.xpm
NO assets/north.xpm
SO assets/south.xpm


F assets/floor.xpm

WE           assets/west.xpm
EA assets/east.xpm

SK 

        111 111111111111111111111
        1011100000110000000000001
        10110000011100000000000011
        1000000000000000000000001
111111111011000001110000000000001
110000000011000000000111111111111
111001111111111111000000100111
111001111111   111010100100111
110000001111111111000100D00001
100000000000000011000100100011
10000000000000001101000000011
11000001110101011111011110E0111
11110001 1111101 100011000001
11111111 111  11 111111111111


