
C 52, 174, 235

NO assets/north.xpm
SO assets/south.xpm


F 77, 209, 106

WE           assets/west.xpm
EA assets/east.xpm


        111 11111111111111111111111111111111111111111111111111111111111111111111111111111
        101110000011000000000000000000000000000000000000000000000000000000000000000000001
        1011000001110000000000000000000000000000000000000000000000000000000000000000000011
        1000000000000000000000000000000000000000000000000000000000000000000000000000000001
1111111110110000011100000000000000E00000000000000000000000000000000000000000000000000000011
110000000011000001110000000000000000000000000000000000000000000000000000000000000111111111111
111101111111111111000000100000000000000000000000000000000000000000000000000000000000000111
11110111111111   1010100100000000000000000000000000000000000000000000000000000000000000111
110000001101111111000100100000000000000000000000000000000000000000000000000000000000000001
1000000000000000110001001000000000000000000000000000000000000000000000000000000000000000111
1000000000000000110100000000000000000000000000000000000000000000000000000000000000000000001
1000000000000000000000000000000000000000000000000000000000000000000000000000000000000000011
1000000000000000000000000000000000000000000000000000000000000000000000000000000000000000011
1000000000000000000000000000000000000000000000000000000000000000000000000000000000000000011
1000000000000000000000000000000000000000000000000000000000000000000000000000000000000000011
1000000000000000000000000000000000000000000000000000000000000000000000000000000000000000011
1000000000000000000000000000000000000000000000000000000000000000000000000000000000000000011
1000000000000000000000000000000000000000000000000000000000000000000000000000000000000000011
1000000000000000000000000000000000000000000000000000000000000000000000000000000000000000011
1000000000000000000000000000000000000000000000000000000000000000000000000000000000000000011
1100000111010101111101111000000000000000000000000000000000000000000000000000000000000000111
11110001 1110101 100011000000000000000000000000000000000000000000000000000000000000000001
11111111 1111111 111111111111111111111111111111111111111111111111111111111111111111111111111111

