
C 52, 174, 235

NO assets/north.xpm
SO assets/south.xpm


F 77, 209, 106

WE           assets/west.xpm
EA assets/east.xpm


        111 1111111111111111111111
        10111000001100000000000001
        10110000011100000000000011
        1000000000000000000000001
1111111110110000011100000000000011
110000000011000001110111111111111
111101111111111111000B00100111
11110111111111   1010100100111
110000001101111111000100100001
1000000000000000110001001000111
1000000000000000110100000000001
11000001110101011111011110N0111
11110001 1110101 100011000001
11111111 1111111 111111111111

